1 2 3 4 1 2 3 4 1 2 3 4 1 14 15 3 4 3 2 1
5 6 7 8 5 6 7 8 5 6 7 8 5 16 17 7 8 5 6 7
9 10 11 12 9 10 11 12 9 10 11 12 9 18 19 11 12 9 10 11
0 0 0 13 0 0 0 13 0 0 0 13 0 0 0 0 13 0 0 0
0 0 0 0 0 0 0 0 0 0 0 0 0 0 0 0 0 0 0 0
0 0 0 0 0 0 0 0 0 0 0 0 0 0 0 0 0 0 0 0
0 0 0 0 0 0 0 0 0 0 0 0 0 0 0 0 0 0 0 0
0 0 0 0 0 0 0 0 0 0 0 0 0 0 0 0 0 0 0 0
0 0 0 0 0 0 0 0 0 0 0 0 0 0 0 0 0 0 0 0
0 0 0 0 0 0 0 0 0 0 0 0 0 0 0 0 0 0 0 0
0 0 0 0 0 0 0 0 0 0 0 0 0 0 0 0 0 0 0 0
0 0 0 0 0 0 0 0 0 0 0 0 0 0 0 0 0 0 0 0