10 10 10 10 10 10 11 12 12 21 12 12 12 13 10 10 10 10 10 10
10 10 10 10 10 10 14 25 26 22 24 25 25 15 10 10 10 10 10 10
10 10 10 10 10 10 14 28 29 23 27 28 28 15 10 10 10 10 10 10
10 10 10 10 10 10 14 30 31 41 31 31 32 15 10 10 10 10 10 10
10 10 10 10 10 10 14 33 42 43 44 45 35 15 10 10 10 10 10 10
10 10 10 10 10 10 14 33 46 47 47 48 35 15 10 10 10 10 10 10
10 10 10 10 10 10 14 33 49 47 47 50 35 15 10 10 10 10 10 10
10 10 10 10 10 10 14 33 51 52 53 54 35 15 10 10 10 10 10 10
10 10 10 10 10 10 14 33 34 55 34 34 35 15 10 10 10 10 10 10
10 10 10 10 10 10 14 36 37 39 10 10 40 15 10 10 10 10 10 10
10 10 10 10 10 10 16 17 17 19 10 10 20 18 10 10 10 10 10 10
10 10 10 10 10 10 10 10 10 10 10 10 10 10 10 10 10 10 10 10